You woke up from a quick nap on some cardboard box. The world through the apartment's window is straight out of your worst nightmare. People rustling garbage, scavenging for anything useful. Zombies roam the street, waiting for their next prey to feast on.

No More Room
An Interactive Fiction by Damian Nguyen
Release 1 / Serial number 250221 / Inform 7 v10.1.2 / D

Broken down apartment
Your home, or at least a shell of what it was before the outbreak. Amidst all the chaos, you still chose this place at your base of operation.

You can see Laura and David here.

>Look David
Once full of life and confidence, the once brave firefighter now relies on a crutch to support his damaged leg. Despite his condition, his sharp eyes still retain a flicker of the person he used to be. His once gruff demeanor has softened, but it's clear he struggles every day just to survive.

>Look Laura
The kid is still too young to fully understand the horror of what's happening around her. Used to be a high school student and captain of the cheerleading team, her eyes carry a mixture of innocence and fear, but you can see a surprising resilience in her-she's survived this long when so many others haven't. Her hands tremble when she holds a weapon, but she's learning fast.

* * *

You woke up from a quick nap on some cardboard box. The world through the apartment's window is straight out of your worst nightmare. People rustling garbage, scavenging for anything useful. Zombies roam the street, waiting for their next prey to feast on.

No More Room
An Interactive Fiction by Damian Nguyen
Release 1 / Serial number 250221 / Inform 7 v10.1.2 / D

Broken down apartment
Your home, or at least a shell of what it was before the outbreak. Amidst all the chaos, you still chose this place at your base of operation.

You can see Laura and David here.

>close backpack
You zip up the backpack, securing everything inside.

>drop backpack
You can't afford to leave your backpack behind. It's your lifeline.

>go west
Your companions follow close behind.

>go west
The ICU is a dark, ruined ward filled with overturned beds and broken medical equipment. The supplies are within reach, but so is death. The groans of the infected grow louder as you approach.
Who will go in? (Type "send yourself", "send David", or "send Laura".)

>send David
David nods and limps toward the ICU. He moves slower than you'd like, but he manages to grab the supplies. Just as he turns back, a zombie lunges at him-he barely fights it off and escapes. Back at the apartment, he insists he's fine.

Broken down apartment
Your home, or at least a shell of what it was before the outbreak. Amidst all the chaos, you still chose this place at your base of operation.

Your companions follow close behind.

>open backpack
You unzip the backpack and see the few supplies you have left, carefully packed away. What do you want to take or do next?

>drop medical supplies
You haven't got that.

* * *

>inventory
You are carrying:
  a backpack
    a medical supplies
    a knife
    a bottle of water
    a pistol

* * *

>close backpack
You zip up the backpack, securing everything inside.

>go hospital
You can't see any such thing.

>go west
Your companions follow close behind.

>look hospital
You can't see any such thing.

>look the hospital
You can't see any such thing.

* * *

>close backpack
You zip up the backpack, securing everything inside.

>go north
Your companions follow close behind.

>go west
On the way to the deli store, you spot a middle-aged man wearing some sort of white outfit with an orange hood. He holds an assault rifle, and some followers stand behind him, wearing the same outfit. They are mumbling something, almost chant-like. You, sensing a potential threat, decided to use the last of your bullets to distract him. You group waits for you back in the supermarket.

>go west
Your companions follow close behind.

>talk to david
David eyes the shelves, his sharp gaze scanning for anything useful. "Damn shame... Places like this used to be a lifesaver. Now they're just tombs." He sighs, then looks at you. "We should keep moving. No sense in standing around.

>talk to laura
Laura runs her fingers over a dusty countertop, a wistful look in her eyes. "My mom used to take me to a place like this," she says softly. "She always let me pick out a treat. I'd always go for the chocolate-covered pretzels-she hated them but bought them anyway." She shakes her head, snapping herself out of the memory. "Anyway, we should keep moving. I think we need to head west.

>go west
Your companions follow close behind.

>talk to david
David looks around the ruined office space with a thoughtful expression. "Used to know a guy who worked in a place like this. Always complained about the coffee." He chuckles, shaking his head. "Bet he'd take burnt coffee over this any day."

>talk to laura
Laura glances around the ruined office, her expression somber. "Y'know... my mom used to work in a place like this. She'd pick me up after her shift, and we'd grab dinner together. Those were good days." She exhales, forcing a smile. "But that was another lifetime ago, huh? We should keep moving. But I do not know where to go, let's ask that suvivor over there"

>go south
You turn to David and Laura. "There's no way all of us make it unless someone buys time."
Before they can protest, you sprint forward, yelling, drawing the horde away. As the undead swarm toward you, you see David-strong, uninjured-grab Laura's wrist and pull her to safety.
You fight until the bitter end, but there's too many. Your vision fades as the zombies overwhelm you.

    *** You gave your life so David and Laura could live. ***

Would you like to RESTART, RESTORE a saved game, QUIT or UNDO the last command?

* * *

>go north
Your companions follow close behind.

>look
Supermarket
The supermarket is a chaotic mess, with overturned shelves, shattered glass, and rotting food scattered everywhere. The faint smell of decay lingers in the air. Despite the destruction, there might still be useful supplies here-if you're brave enough to search.

You can see Laura, David, a canned food, a flashlight and a zombie here.

>take canned food
The zombie lunges at you as you reach for the canned food! You barely manage to dodge its grasp.
You quickly pull out your knife and stab the zombie in the head. It collapses to the ground, lifeless.

>open backpack
You unzip the backpack and see the few supplies you have left, carefully packed away. What do you want to take or do next?

>inventory
You are carrying:
  a backpack
    a knife
    a bottle of water
    a pistol

>take canned food
The canned food is now in your backpack.

>open backpack
The backpack is already open.

>inventory
You are carrying:
  a backpack
    a canned food
    a knife
    a bottle of water
    a pistol

>close backpack
You zip up the backpack, securing everything inside.

* * *

>go north
Your companions follow close behind.

>take canned food
The zombie lunges at you as you reach for the canned food! You barely manage to dodge its grasp.
You have a split second to act. What will you do? (Type "use knife" or "use pistol".)

>use pistol
You pull out your gun and fire. The zombie's head snaps back, and it crumples to the floor. The gun made quite a sound, hopefully it does not attract unwanted attention.

>go west
Shadows shift in the corners. Hooded figures emerge from behind the counter. They are all wearing some sort of white outfits with orange hoods. One of them shouts, "The unclean must be purged!" before gunfire erupts. You manage to drive them away with your pistol, but it seems that Laura caught a stray bullet.

>go west
Your companions follow close behind.

>look
Deli Store
A small, cramped space with glass-fronted shelves stocked with non-perishable items. A faded neon sign hangs above the counter, flickering intermittently. Before the outbreak, you used to come here every day to get supplies.

You can see Laura and David here.

Laura collapses to the ground, her breath slowing. She was hit in the stomach and is losing blood quickly. Without some medical supplies to stop the bleeding, she might not make it through this one.

* * *

>go west
Shadows shift in the corners. Hooded figures emerge from behind the counter. They are all wearing some sort of white outfits with orange hoods. One of them shouts, "The unclean must be purged!" before gunfire erupts. You manage to drive them away with your pistol, but it seems that Laura caught a stray bullet.

>talk to laura
Laura: I don't want to die, you won't let me die right, I will live and find my parents *cough heaviliy*

* * *

>go west
Laura can't continue the journey with an untreated bullet hole. Without supplies to treat the wound, Laura quickly stumble to the ground, laying in a pool of her own blood. Soon, she succumb to death. 

    *** Although it is not your fault, with David yelling at your for letting Laura die, the sheer horror of Laura drowning in her own blood was too much for you. With a quick motion, you slit your own throat and lay next to Laura. David, limping away from the body, never to be seen again. ***

Would you like to RESTART, RESTORE a saved game, QUIT or UNDO the last command?

* * *

>use pistol
You pull out your gun and fire. The zombie's head snaps back, and it crumples to the floor. The gun made quite a sound, hopefully it does not attract unwanted attention.

>take canned food
The canned food is now in your backpack.

>take flashlight
The flashlight is now in your backpack.

>go west
Shadows shift in the corners. Hooded figures emerge from behind the counter. They are all wearing some sort of white outfits with orange hoods. One of them shouts, "The unclean must be purged!" before gunfire erupts. You manage to drive them away with your pistol, but it seems that Laura caught a stray bullet.

>talk to Laura
Laura doesn't reply.

>go west
Laura can't continue the journey with an untreated bullet hole. Without supplies to treat the wound, Laura quickly stumble to the ground, laying in a pool of her own blood. Soon, she succumb to death. 

    *** Although it is not your fault, with David yelling at your for letting Laura die, the sheer horror of Laura drowning in her own blood was too much for you. With a quick motion, you slit your own throat and lay next to Laura. David, limping away from the body, never to be seen again. ***

Would you like to RESTART, RESTORE a saved game, QUIT or UNDO the last command?

* * *

>close backpack
You zip up the backpack, securing everything inside.

>go west
Your companions follow close behind.

* * *

>send David
David nods and limps toward the ICU. He moves slower than you'd like, but he manages to grab the supplies. Just as he turns back, a zombie lunges at him-he barely fights it off and escapes. Back at the apartment, he insists he's fine.

Broken down apartment
Your home, or at least a shell of what it was before the outbreak. Amidst all the chaos, you still chose this place at your base of operation.

Your companions follow close behind.

>go north
Your companions follow close behind.

>go north
You can't go that way.

>go west
On the way to the deli store, you spot a middle-aged man wearing some sort of white outfit with an orange hood. He holds an assault rifle, and some followers stand behind him, wearing the same outfit. They are mumbling something, almost chant-like. You, sensing a potential threat, decided to use the last of your bullets to distract him. You group waits for you back in the supermarket.

>talk to david
We should look around for anything that might be useful: food, water and any weapon is useful. It is a long road ahead

>talk to laura
I think after this stop we can continue west to the Deli store west of here. That will help us avoid the open street crawling with zombies. Yikes!

>go west
Your companions follow close behind.

>talk to david
David mumbles something under his breath, his voice thick, words slurring. "Hot... burnin" up..." His fingers twitch against his crutch. "We... go... whessst..." His eyelids flutter as he grips his forehead, his breath coming in ragged gasps.
David eyes the shelves, his sharp gaze scanning for anything useful. "Damn shame... Places like this used to be a lifesaver. Now they're just tombs." He sighs, then looks at you. "We should keep moving. No sense in standing around.

* * *

>go west
Your companions follow close behind.

>go west
David starts to experience a violent spasm. His eyes twitch, and his hands claw at the dirt. His mouth foams as he groans in pain. You spot a bite mark about two centimeters deep in his good leg-he must have gotten that in the ICU and hid it from you. 

 What will you do? (Amputate David or End David)

>Amputate
(the backpack)

>Amputate David
Without hesitation, you take the bonesaw in the medical supplies and start hacking away David's leg. Although he is turning, the pain is still too much for a person to handle. He lets out a bloodcurdling scream as the sawblade digs into his flesh. After a clean cut, you quickly wrap his leg in bandages and cauterize the wound. He seems to be stable, for now.

>lookj
That's not a verb I recognise.

>look
Deli Store
A small, cramped space with glass-fronted shelves stocked with non-perishable items. A faded neon sign hangs above the counter, flickering intermittently. Before the outbreak, you used to come here every day to get supplies.

You can see Laura and David here.

* * *

>go west
David starts to experience a violent spasm. His eyes twitch, and his hands claw at the dirt. His mouth foams as he groans in pain. You spot a bite mark about two centimeters deep in his good leg-he must have gotten that in the ICU and hid it from you. 

 What will you do? (Amputate David or End David)

>end david
David stumbles back, groaning. His skin darkens, his breath ragged. His body twitches uncontrollably as the infection fully takes hold. His eyes, once familiar, now stare at you with a vacant, predatory hunger. With a swift stab to the skull, you quickly end his suffering.

>talk to laura
Laura looks at you, eyes red from crying. "You... you really did it." She swallows hard, hugging herself. "I know he was turning, but... I can't believe he's gone." She looks away, unable to meet your gaze.

>talk to david
David's body lies still on the cold floor, his features frozen in a grimace. The deli's dim light casts long shadows over his lifeless form. Your knife is still slick with his blood, a reminder of the choice you had to make. For a moment, silence fills the store

>go west
Your companions follow close behind.

>look
Office Complex
A dilapidated office building with shattered windows and debris scattered everywhere. The air smells of dust and decay. A lone survivor stands near the entrance, looking desperate. Your group seems lost, you should ask someone for direction. 

You can see Laura and Jisoo here.

>talk to laura
Laura glances around the ruined office, her expression somber. "Y'know... my mom used to work in a place like this. She'd pick me up after her shift, and we'd grab dinner together. Those were good days." She exhales, forcing a smile. "But that was another lifetime ago, huh? We should keep moving. But I do not know where to go, let's ask that suvivor over there"

>talk to jisoo
"Do you have any food or water?" Jisoo asks, her voice trembling. "I haven't eaten in days... I need both to survive."
You don't have anything to give her. She looks at you with despair in her eyes. "Please... come back if you find anything."

>talk to david
You can't see any such thing.

>go east
You can't go that way.

>go west
You can't go that way.

>go north
A massive horde of zombies blocks the way to the park. You'll need to find a way to distract them.

>go south
You turn to David and Laura. "There's no way all of us make it unless someone buys time."
Before they can protest, you sprint forward, yelling, drawing the horde away. As the undead swarm toward you, you see David-strong, uninjured-grab Laura's wrist and pull her to safety.
You fight until the bitter end, but there's too many. Your vision fades as the zombies overwhelm you.

    *** You gave your life so David and Laura could live. ***

Would you like to RESTART, RESTORE a saved game, QUIT or UNDO the last command?

>undo
Office Complex
[Previous turn undone.]

>go south
You turn to David and Laura. "There's no way all of us make it unless someone buys time."
Before they can protest, you sprint forward, yelling, drawing the horde away. As the undead swarm toward you, you see David-strong, uninjured-grab Laura's wrist and pull her to safety.
You fight until the bitter end, but there's too many. Your vision fades as the zombies overwhelm you.

    *** You gave your life so David and Laura could live. ***

Would you like to RESTART, RESTORE a saved game, QUIT or UNDO the last command?

* * *

>go west
Your companions follow close behind.

>talk to david
David mumbles something under his breath, his voice thick, words slurring. "Hot... burnin" up..." His fingers twitch against his crutch. "We... go... whessst..." His eyelids flutter as he grips his forehead, his breath coming in ragged gasps.

>talk to laura
Laura runs her fingers over a dusty countertop, a wistful look in her eyes. "My mom used to take me to a place like this," she says softly. "She always let me pick out a treat. I'd always go for the chocolate-covered pretzels-she hated them but bought them anyway." She shakes her head, snapping herself out of the memory. "Anyway, we should keep moving. I think we need to head west.

>go west
David starts to experience a violent spasm. His eyes twitch, and his hands claw at the dirt. His mouth foams as he groans in pain. You spot a bite mark about two centimeters deep in his good leg-he must have gotten that in the ICU and hid it from you. 

 What will you do? (Amputate David or End David)

* * *

>talk to laura
Laura looks at you, eyes red from crying. "You... you really did it." She swallows hard, hugging herself. "I know he was turning, but... I can't believe he's gone." She looks away, unable to meet your gaze.

>talk to david
David's body lies still on the cold floor, his features frozen in a grimace. The deli's dim light casts long shadows over his lifeless form. Your knife is still slick with his blood, a reminder of the choice you had to make. For a moment, silence fills the storeDavid eyes the shelves, his sharp gaze scanning for anything useful. "Damn shame... Places like this used to be a lifesaver. Now they're just tombs." He sighs, then looks at you. "We should keep moving. No sense in standing around.

* * *

>take canned food
The zombie lunges at you as you reach for the canned food! You barely manage to dodge its grasp.
You have a split second to act. What will you do? (Type "use knife" or "use pistol".)

>use knife
You quickly pull out your knife and stab the zombie in the head. It collapses to the ground, lifeless.

>go north
You can't go that way.

>go west
Your companions follow close behind.

>look
Deli Store
A small, cramped space with glass-fronted shelves stocked with non-perishable items. A faded neon sign hangs above the counter, flickering intermittently. Before the outbreak, you used to come here every day to get supplies.

You can see Laura, David and Wallace here.

David starts to experience a violent spasm. His eyes twitch, and his hands claw at the dirt. His mouth foams as he groans in pain. You spot a bite mark about two centimeters deep in his bad leg-he must have gotten that in the ICU and hid it from you.
You only have enough supplies to save one. Who will you choose? (Type "use medical supplies on David" or "use medical supplies on Laura").

>use medical supplies on David
Without hesitation, you take the bonesaw in the medical supplies and start hacking away David's leg. Although he is turning, the pain is still too much for a person to handle. He lets out a bloodcurdling scream as the sawblade digs into his flesh. After a clean cut, you quickly wrap his leg in bandages and cauterize the wound. He seems to be stable, for now.
Laura, lying in her own pool of blood, feels cold and lifeless. She has lost too much blood from the wound.

* * *

>use knife
You quickly pull out your knife and stab the zombie in the head. It collapses to the ground, lifeless.

>go west
Your companions follow close behind.

* * *

>use medical supplies on David
Without hesitation, you take the bonesaw in the medical supplies and start hacking away David's leg. Although he is turning, the pain is still too much for a person to handle. He lets out a bloodcurdling scream as the sawblade digs into his flesh. After a clean cut, you quickly wrap his leg in bandages and cauterize the wound. He seems to be stable, for now.

>look
Deli Store
A small, cramped space with glass-fronted shelves stocked with non-perishable items. A faded neon sign hangs above the counter, flickering intermittently. Before the outbreak, you used to come here every day to get supplies.

You can see Laura, David and Wallace here.

>look Wallace
You see nothing special about Wallace.

* * *

>use pistol
You pull out your gun and fire. The zombie's head snaps back, and it crumples to the floor. The gun made quite a sound, hopefully it does not attract unwanted attention.

>go west
Shadows shift in the corners. Hooded figures emerge from behind the counter. They are all wearing some sort of white outfits with orange hoods. One of them shouts, "The unclean must be purged!" before gunfire erupts. You manage to drive them away with your pistol, but it seems that Laura caught a stray bullet. You carry Laura back to the supermarket to check on her.

>go west
Laura can't continue the journey with an untreated bullet hole. Luckily, with the supplies retrieve from ICU, you administer a dose of painkiller and carefully cauterize her wound and wrap it up. She lost a lot of blood, but she is stable for now

* * *

>channign tatum
That's not a verb I recognise.

>open backpack
You unzip the backpack and see the few supplies you have left, carefully packed away. What do you want to take or do next?

>look inventory
You can't see any such thing.

* * *

>go west
Laura can't continue the journey with an untreated bullet hole. Luckily, with the supplies retrieve from ICU, you administer a dose of painkiller and carefully cauterize her wound and wrap it up. She lost a lot of blood, but she is stable for now

>go west
Your companions follow close behind.

>look
Deli Store
A small, cramped space with glass-fronted shelves stocked with non-perishable items. A faded neon sign hangs above the counter, flickering intermittently. Before the outbreak, you used to come here every day to get supplies.

You can see Laura and David here.

>go west
David starts to experience a violent spasm. His eyes twitch, and his hands claw at the dirt. His mouth foams as he groans in pain. You spot a bite mark about two centimeters deep in his good leg-he must have gotten that in the ICU and hid it from you. 

 What will you do? (Cut David's leg off or End his suffering

>end his suffering
That's not a verb I recognise.

>end David's suffering
That's not a verb I recognise.

>cut David's leg off
You must supply a noun.

>amputate david's leg
You must supply a noun.

* * *

>go west
Laura can't continue the journey with an untreated bullet hole. Luckily, with the supplies retrieve from ICU, you administer a dose of painkiller and carefully cauterize her wound and wrap it up. She lost a lot of blood, but she is stable for now

>look
Deli Store
A small, cramped space with glass-fronted shelves stocked with non-perishable items. A faded neon sign hangs above the counter, flickering intermittently. Before the outbreak, you used to come here every day to get supplies.

You can see Laura and David here.

Laura collapses to the ground, her breath slowing. She was hit in the stomach and is losing blood quickly. Without some medical supplies to stop the bleeding, she might not make it through this one.

David starts to experience a violent spasm. His eyes twitch, and his hands claw at the dirt. His mouth foams as he groans in pain. You spot a bite mark about two centimeters deep in his bad leg-he must have gotten that in the ICU and hid it from you.
You only have enough supplies to save one. Who will you choose? (Type "use medical supplies on David" or "use medical supplies on Laura").

>use medical supplies on Laura
You kneel beside Laura, pressing down on her wound. Her breathing is shallow, her face pale. You fumble for the medical supplies, tearing open bandages and injecting a dose of painkillers. She winces but manages a weak smile.
David stumbles back, groaning. His skin darkens, his breath ragged. His body twitches uncontrollably as the infection fully takes hold. His eyes, once familiar, now stare at you with a vacant, predatory hunger. With a swift stab to the skull, you quickly end his suffering.

>look
Deli Store
A small, cramped space with glass-fronted shelves stocked with non-perishable items. A faded neon sign hangs above the counter, flickering intermittently. Before the outbreak, you used to come here every day to get supplies.

You can see Laura here.

* * *

>go west
Shadows shift in the corners. Hooded figures emerge from behind the counter. They are all wearing some sort of white outfits with orange hoods. One of them shouts, "The unclean must be purged!" before gunfire erupts. You manage to drive them away with your pistol, but it seems that Laura caught a stray bullet. You carry Laura back to the supermarket to check on her.

>look
Supermarket
The supermarket is a chaotic mess, with overturned shelves, shattered glass, and rotting food scattered everywhere. The faint smell of decay lingers in the air. Despite the destruction, there might still be useful supplies here-if you're brave enough to search.

You can see Laura, David, a canned food and a flashlight here.

>take canned food
The canned food is now in your backpack.

* * *

>take flashlight
The flashlight is now in your backpack.

>go west
Your companions follow close behind.

* * *

>go west
Shadows shift in the corners. Hooded figures emerge from behind the counter. They are all wearing some sort of white outfits with orange hoods. One of them shouts, "The unclean must be purged!" before gunfire erupts. You manage to drive them away with your pistol, but it seems that Laura caught a stray bullet. You carry Laura back to the supermarket to check on her.

>talk to laura
Don't worry about me, we have medical supplies from earlier right. I will be back to my full strength in no time. Let's keep pushing west

>go west
Laura can't continue the journey with an untreated bullet hole. Luckily, with the supplies retrieve from ICU, you administer a dose of painkiller and carefully cauterize her wound and wrap it up. She lost a lot of blood, but she is stable for now
Your companions follow close behind.

>talk to david
David mumbles something under his breath, his voice thick, words slurring. "Hot... burnin" up..." His fingers twitch against his crutch. "We... go... whessst..." His eyelids flutter as he grips his forehead, his breath coming in ragged gasps.

* * *

>end david
David stumbles back, groaning. His skin darkens, his breath ragged. His body twitches uncontrollably as the infection fully takes hold. His eyes, once familiar, now stare at you with a vacant, predatory hunger. With a swift stab to the skull, you quickly end his suffering.

>talk to david
David mumbles something under his breath, his voice thick, words slurring. "Hot... burnin" up..." His fingers twitch against his crutch. "We... go... whessst..." His eyelids flutter as he grips his forehead, his breath coming in ragged gasps.
David's body lies still on the cold floor, his features frozen in a grimace. The deli's dim light casts long shadows over his lifeless form. Your knife is still slick with his blood, a reminder of the choice you had to make. For a moment, silence fills the store

>talk to laura
Laura looks at you, eyes red from crying. "You... you really did it." She swallows hard, hugging herself. "I know he was turning, but... I can't believe he's gone." She looks away, unable to meet your gaze.

>go west
David starts to experience a violent spasm. His eyes twitch, and his hands claw at the dirt. His mouth foams as he groans in pain. You spot a bite mark about two centimeters deep in his good leg-he must have gotten that in the ICU and hid it from you. 

 What will you do? (Amputate David or End David)

* * *

>talk to laura
Don't worry about me, we have medical supplies from earlier right. I will be back to my full strength in no time. Let's keep pushing west

>talk to david
Poor child, well don't just stand there, do something. Quickly or she will die. D I E!

>go west
Laura can't continue the journey with an untreated bullet hole. Luckily, with the supplies retrieve from ICU, you administer a dose of painkiller and carefully cauterize her wound and wrap it up. She lost a lot of blood, but she is stable for now
Your companions follow close behind.

* * *

>go west
David starts to experience a violent spasm. His eyes twitch, and his hands claw at the dirt. His mouth foams as he groans in pain. You spot a bite mark about two centimeters deep in his good leg-he must have gotten that in the ICU and hid it from you. 

 What will you do? (Amputate David or End David)

* * *

>end david
David stumbles back, groaning. His skin darkens, his breath ragged. His body twitches uncontrollably as the infection fully takes hold. His eyes, once familiar, now stare at you with a vacant, predatory hunger. With a swift stab to the skull, you quickly end his suffering.

>talk to david
You can't see any such thing.

>talk to laura
Laura looks at you, eyes red from crying. "You... you really did it." She swallows hard, hugging herself. "I know he was turning, but... I can't believe he's gone." She looks away, unable to meet your gaze.

* * *

>take canned food
The canned food is now in your backpack.

>go west
Shadows shift in the corners. Hooded figures emerge from behind the counter. They are all wearing some sort of white outfits with orange hoods. One of them shouts, "The unclean must be purged!" before gunfire erupts. You manage to drive them away with your pistol, but it seems that Laura caught a stray bullet. You carry Laura back to the supermarket to check on her.

>go west
Laura can't continue the journey with an untreated bullet hole. Luckily, with the supplies retrieve from ICU, you administer a dose of painkiller and carefully cauterize her wound and wrap it up. She lost a lot of blood, but she is stable for now
Your companions follow close behind.

>look
Deli Store
A small, cramped space with glass-fronted shelves stocked with non-perishable items. A faded neon sign hangs above the counter, flickering intermittently. Before the outbreak, you used to come here every day to get supplies.

You can see Laura and David here.

* * *

>send David
David nods and limps toward the ICU. He moves slower than you'd like, but he manages to grab the supplies. Just as he turns back, a zombie lunges at him-he barely fights it off and escapes. Back at the apartment, he insists he's fine.

Broken down apartment
Your home, or at least a shell of what it was before the outbreak. Amidst all the chaos, you still chose this place at your base of operation.

Your companions follow close behind.

>look
Broken down apartment
Your home, or at least a shell of what it was before the outbreak. Amidst all the chaos, you still chose this place at your base of operation.

You can see Laura and David here.

>go north
Your companions follow close behind.

>talk to laura
I think after this stop we can continue west to the Deli store west of here. That will help us avoid the open street crawling with zombies. Yikes!

>talk to david
We should look around for anything that might be useful: food, water and any weapon is useful. It is a long road ahead

>go west
On the way to the deli store, you spot a middle-aged man wearing some sort of white outfit with an orange hood. He holds an assault rifle, and some followers stand behind him, wearing the same outfit. They are mumbling something, almost chant-like. You, sensing a potential threat, decided to use the last of your bullets to distract him. You group waits for you back in the supermarket.

>talk to laura
I think after this stop we can continue west to the Deli store west of here. That will help us avoid the open street crawling with zombies. Yikes!

* * *

>talk to david
We should look around for anything that might be useful: food, water and any weapon is useful. It is a long road ahead

>go west
Your companions follow close behind.

* * *

>end david
David stumbles back, groaning. His skin darkens, his breath ragged. His body twitches uncontrollably as the infection fully takes hold. His eyes, once familiar, now stare at you with a vacant, predatory hunger. With a swift stab to the skull, you quickly end his suffering.

>go west
Your companions follow close behind.

* * *

>look
Office Complex
A dilapidated office building with shattered windows and debris scattered everywhere. The air smells of dust and decay. A lone survivor stands near the entrance, looking desperate. Your group seems lost, you should ask someone for direction. 

You can see Laura and Jisoo here.

>tallk to jisoo
That's not a verb I recognise.

* * *

>open backpack
You unzip the backpack and see the few supplies you have left, carefully packed away. What do you want to take or do next?

>inventory
You are carrying:
  a backpack
    a medical supplies
    a knife
    a bottle of water
    a pistol

>drop medical supplies
You haven't got that.

* * *

>send David
David nods and limps toward the ICU. He moves slower than you'd like, but he manages to grab the supplies. Just as he turns back, a zombie lunges at him-he barely fights it off and escapes. Back at the apartment, he insists he's fine.

Broken down apartment
Your home, or at least a shell of what it was before the outbreak. Amidst all the chaos, you still chose this place at your base of operation.

Your companions follow close behind.

>talk to Laura
I'm glad we made it out of the ICU unscathed, that medical supplies is going to help us a lot in the upcoming journey, from this map that I have, we have to go north through the supermarket to reach the city border

.

>talk to David
I am fine, things got a bit sticky in there, but I totally owned that zombie, there is still a lot of kick in this old man *cough* *cough*

>go north
Your companions follow close behind.

>talk to Laura
I think after this stop we can continue west to the Deli store west of here. That will help us avoid the open street crawling with zombies. Yikes!

>talk to David
We should look around for anything that might be useful: food, water and any weapon is useful. It is a long road ahead

>take canned food
The zombie lunges at you as you reach for the canned food! You barely manage to dodge its grasp.
You have a split second to act. What will you do? (Type "use knife" or "use pistol".)

* * *

>go west
Shadows shift in the corners. Hooded figures emerge from behind the counter. They are all wearing some sort of white outfits with orange hoods. One of them shouts, "The unclean must be purged!" before gunfire erupts. You manage to drive them away with your pistol, but it seems that Laura caught a stray bullet.

>talk to Laura
Don't worry about me, we have medical supplies from earlier right. I will be back to my full strength in no time. Let's keep pushing west

>talk to David
Poor child, well don't just stand there, do something. Quickly or she will die. D I E!

>go west
Laura can't continue the journey with an untreated bullet hole. Luckily, with the supplies retrieve from ICU, you administer a dose of painkiller and carefully cauterize her wound and wrap it up. She lost a lot of blood, but she is stable for now

* * *

>go west
Your companions follow close behind.

>talk to laura
Laura doesn't reply.

>talk to david
David doesn't reply.

>look
Deli Store
A small, cramped space with glass-fronted shelves stocked with non-perishable items. A faded neon sign hangs above the counter, flickering intermittently. Before the outbreak, you used to come here every day to get supplies.

You can see Laura and David here.

* * *

>go west
The ICU is a dark, ruined ward filled with overturned beds and broken medical equipment. The supplies are within reach, but so is death. The groans of the infected grow louder as you approach.
Who will go in? (Type "send yourself", "send David", or "send Laura".)

>send Laura
Laura moves like a shadow, slipping through gaps in the horde. She returns with the supplies, completely unharmed. Maybe her cheerleading days actually paid off.

Broken down apartment
Your home, or at least a shell of what it was before the outbreak. Amidst all the chaos, you still chose this place at your base of operation.

Your companions follow close behind.

>talk to David
That was brave of you guys going in there while a horde surrounds the ICU. I would not be able to make it at all.

* * *

>go west
Your companions follow close behind.

>look
Hospital
A broken down hospital, its walls cracked and windows shattered. The air is thick with the scent of decay, and the flickering lights barely illuminate the bloodstained floors. Old hospital equipment lies abandoned, rusted and covered in dust. The faint sound of groaning and shuffling echoes from the ICU, where the infected have become trapped. A few scattered medical supplies glint under the dim light, offering a glimmer of hope amidst the chaos. This might come handy in the future.

You can see Laura and David here.

>look laura
The kid is still too young to fully understand the horror of what's happening around her. Used to be a high school student and captain of the cheerleading team, her eyes carry a mixture of innocence and fear, but you can see a surprising resilience in her-she's survived this long when so many others haven't. Her hands tremble when she holds a weapon, but she's learning fast.

* * *

You woke up from a quick nap on some cardboard box. The world through the apartment's window is straight out of your worst nightmare. People rustling garbage, scavenging for anything useful. Zombies roam the street, waiting for their next prey to feast on.

No More Room
An Interactive Fiction by Damian Nguyen
Release 1 / Serial number 250221 / Inform 7 v10.1.2 / D

Broken down apartment
Your home, or at least a shell of what it was before the outbreak. Amidst all the chaos, you still chose this place at your base of operation.

You can see Laura and David here.

>go north
As you step into the Supermarket, pistol slips out of your open backpack. You hear it clatter to the ground behind you, but by the time you look back, it's already gone.

Your companions follow close behind.

* * *

You woke up from a quick nap on some cardboard box. The world through the apartment's window is straight out of your worst nightmare. People rustling garbage, scavenging for anything useful. Zombies roam the street, waiting for their next prey to feast on.

No More Room
An Interactive Fiction by Damian Nguyen
Release 1 / Serial number 250221 / Inform 7 v10.1.2 / D

Broken down apartment
Your home, or at least a shell of what it was before the outbreak. Amidst all the chaos, you still chose this place at your base of operation.

You can see Laura and David here.

>go west
As you step into the Hospital, bottle of water slips out of your open backpack. You hear it clatter to the ground behind you, but by the time you look back, it's already gone.

Your companions follow close behind.

>close backack
You can't see any such thing.

>close backpack
The backpack is already closed.

>go west
The ICU is a dark, ruined ward filled with overturned beds and broken medical equipment. The supplies are within reach, but so is death. The groans of the infected grow louder as you approach.
Who will go in? (Type "send yourself", "send David", or "send Laura".)

* * *

>go west
Shadows shift in the corners. Hooded figures emerge from behind the counter. They are all wearing some sort of white outfits with orange hoods. One of them shouts, "The unclean must be purged!" before gunfire erupts. You manage to drive them away with your pistol, but it seems that Laura caught a stray bullet.

>go west
Laura can't continue the journey with an untreated bullet hole. Luckily, with the supplies retrieve from ICU, you administer a dose of painkiller and carefully cauterize her wound and wrap it up. She lost a lot of blood, but she is stable for now

* * *

>go west
Your companions follow close behind.

>go west
David starts to experience a violent spasm. His eyes twitch, and his hands claw at the dirt. His mouth foams as he groans in pain. You spot a bite mark about two centimeters deep in his good leg-he must have gotten that in the ICU and hid it from you. 

 What will you do? (Amputate David or End David

>amputate David
That's not a verb I recognise.

>amputate
That's not a verb I recognise.

* * *

>go west
As you step into the Hospital, bottle of water slips out of your open backpack. You hear it clatter to the ground behind you, but by the time you look back, it's already gone.

Your companions follow close behind.

>go west
The ICU is a dark, ruined ward filled with overturned beds and broken medical equipment. The supplies are within reach, but so is death. The groans of the infected grow louder as you approach.
Who will go in? (Type "send yourself", "send David", or "send Laura".)

>s
You can't go that way.

>send yourself
You take a deep breath and step into the ICU. The sight is overwhelming, but you move quickly, grabbing as much as you can. Unfortunately, your movement stirs the horde, and they begin breaking free. You barely escape, but the threat is growing.

Broken down apartment
Your home, or at least a shell of what it was before the outbreak. Amidst all the chaos, you still chose this place at your base of operation.

Your companions follow close behind.

>look medical supplies
A first aid kit along with some essential supplies for bite wounds, antibiotics and bandages

* * *

>look
Supermarket
The supermarket is a chaotic mess, with overturned shelves, shattered glass, and rotting food scattered everywhere. The faint smell of decay lingers in the air. Despite the destruction, there might still be useful supplies here-if you're brave enough to search.

You can see Laura, David, a canned food, a flashlight and a zombie here.

>take canned food
The zombie lunges at you as you reach for the canned food! You barely manage to dodge its grasp.
You have a split second to act. What will you do? (Type "use knife" or "use pistol".)

>pistol
That's not a verb I recognise.

>use pistol
You pull out your gun and fire. The zombie's head snaps back, and it crumples to the floor. The gun made quite a sound, hopefully it does not attract unwanted attention.

* * *

>go west
David starts to experience a violent spasm. His eyes twitch, and his hands claw at the dirt. His mouth foams as he groans in pain. You spot a bite mark about two centimeters deep in his good leg-he must have gotten that in the ICU and hid it from you. 

 What will you do? (Amputate David or End David

>End David
David stumbles back, groaning. His skin darkens, his breath ragged. His body twitches uncontrollably as the infection fully takes hold. His eyes, once familiar, now stare at you with a vacant, predatory hunger. With a swift stab to the skull, you quickly end his suffering.

>look
Deli Store
A small, cramped space with glass-fronted shelves stocked with non-perishable items. A faded neon sign hangs above the counter, flickering intermittently. Before the outbreak, you used to come here every day to get supplies.

You can see Laura and David here.

* * *

>take canned food
The zombie lunges at you as you reach for the canned food! You barely manage to dodge its grasp.
You have a split second to act. What will you do? (Type "use knife" or "use pistol".)

>undo
Supermarket
[Previous turn undone.]

>inventory
You are carrying:
  a backpack

>open backpack
You unzip the backpack and see the few supplies you have left, carefully packed away. What do you want to take or do next?

>inventory
You are carrying:
  a backpack
    a medical supplies
    a bottle of water
    a pistol

>take canned food
You scramble back, realizing you're unarmed. You'll need a weapon to deal with this threat.

    *** You were overwhelmed by the zombie. ***

Would you like to RESTART, RESTORE a saved game, QUIT or UNDO the last command?

* * *

>use knife
You quickly pull out your knife and stab the zombie in the head. It collapses to the ground, lifeless.

>go west
On the way to the deli store, you spot a middle-aged man wearing some sort of white outfit with an orange hood. He holds an assault rifle, and some followers stand behind him, wearing the same outfit. They are mumbling something, almost chant-like. You, sensing a potential threat, decided to use the last of your bullets to distract him.

>go west
Your companions follow close behind.

* * *

>look
Deli Store
A small, cramped space with glass-fronted shelves stocked with non-perishable items. A faded neon sign hangs above the counter, flickering intermittently. Before the outbreak, you used to come here every day to get supplies.

You can see Laura and David here.

>talk to Laura
Laura doesn't reply.

>talk to David
David doesn't reply.

>go west
David starts to experience a violent spasm. His eyes twitch, and his hands claw at the dirt. His mouth foams as he groans in pain. You spot a bite mark about two centimeters deep in his good leg-he must have gotten that in the ICU and hid it from you. 

 What will you do? (Amputate David or End David)

>End David
David stumbles back, groaning. His skin darkens, his breath ragged. His body twitches uncontrollably as the infection fully takes hold. His eyes, once familiar, now stare at you with a vacant, predatory hunger. With a swift stab to the skull, you quickly end his suffering.

>look
Deli Store
A small, cramped space with glass-fronted shelves stocked with non-perishable items. A faded neon sign hangs above the counter, flickering intermittently. Before the outbreak, you used to come here every day to get supplies.

You can see Laura here.

* * *

>go west
Shadows shift in the corners. Hooded figures emerge from behind the counter. They are all wearing some sort of white outfits with orange hoods. One of them shouts, "The unclean must be purged!" before gunfire erupts. You manage to drive them away with your pistol, but it seems that Laura caught a stray bullet. You carry Laura back to the supermarket to check on her.

>talk to Laura
Don't worry about me, we have medical supplies from earlier right. I will be back to my full strength in no time. Let's keep pushing west

>talk to david
Poor child, well don't just stand there, do something. Quickly or she will die. D I E!

>go west
Laura can't continue the journey with an untreated bullet hole. Luckily, with the supplies retrieve from ICU, you administer a dose of painkiller and carefully cauterize her wound and wrap it up. She lost a lot of blood, but she is stable for now

* * *

>send Laura
Laura moves like a shadow, slipping through gaps in the horde. She returns with the supplies, completely unharmed. Maybe her cheerleading days actually paid off.

Broken down apartment
Your home, or at least a shell of what it was before the outbreak. Amidst all the chaos, you still chose this place at your base of operation.

Your companions follow close behind.

>go west
There is nothing left for us in the hospital. We should focus on the journey to the city border.

* * *

>send Laura
Laura moves like a shadow, slipping through gaps in the horde. She returns with the supplies, completely unharmed. Maybe her cheerleading days actually paid off.

Broken down apartment
Your home, or at least a shell of what it was before the outbreak. Amidst all the chaos, you still chose this place at your base of operation.

Your companions follow close behind.

>look medical supplies
A first aid kit along with some essential supplies for bite wounds, antibiotics and bandages

>

* * *

>go west
The ICU is a dark, ruined ward filled with overturned beds and broken medical equipment. The supplies are within reach, but so is death. The groans of the infected grow louder as you approach.
Who will go in? (Type "send yourself", "send David", or "send Laura".)

>send laura
Laura moves like a shadow, slipping through gaps in the horde. She returns with the supplies, completely unharmed. Maybe her cheerleading days actually paid off.

Broken down apartment
Your home, or at least a shell of what it was before the outbreak. Amidst all the chaos, you still chose this place at your base of operation.

Your companions follow close behind.

>

>inventory
You are carrying:
  a medical supplies
  a backpack

>

>look backpack
A simple, worn-out backpack that holds your few remaining supplies. It's clear that you can't carry much more, every item inside is critical to your survival.

>

* * *

>inventory
You are carrying:
  a medical supplies
  a backpack

>

>look medical supplies
You see nothing special about the medical supplies.

>

>look backpack
A simple, worn-out backpack that holds your few remaining supplies. It's clear that you can't carry much more, every item inside is critical to your survival.

>

* * *

>go west
The ICU is a dark, ruined ward filled with overturned beds and broken medical equipment. The supplies are within reach, but so is death. The groans of the infected grow louder as you approach.
Who will go in? (Type "send yourself", "send David", or "send Laura".)

>send west
That's not a valid choice. Type "send yourself", "send David", or "send Laura".

>send laura
Laura moves like a shadow, slipping through gaps in the horde. She returns with the supplies, completely unharmed. Maybe her cheerleading days actually paid off.

Broken down apartment
Your home, or at least a shell of what it was before the outbreak. Amidst all the chaos, you still chose this place at your base of operation.

Your companions follow close behind.

>go north
Your companions follow close behind.

>take knife
You can't see any such thing.

>look backpack
A simple, worn-out backpack that holds your few remaining supplies. It's clear that you can't carry much more, every item inside is critical to your survival.

>inventory
You are carrying:
  a medical supplies
  a backpack

* * *

>go west
The ICU is a dark, ruined ward filled with overturned beds and broken medical equipment. The supplies are within reach, but so is death. The groans of the infected grow louder as you approach.
Who will go in? (Type "send yourself", "send David", or "send Laura".)

>send yourself
You take a deep breath and step into the ICU. The sight is overwhelming, but you move quickly, grabbing as much as you can. Unfortunately, your movement stirs the horde, and they begin breaking free. You barely escape, but the threat is growing.

ICU
Your companions follow close behind.

>

* * *

>go west
As you step into the Hospital, bottle of water slips out of your open backpack. You hear it clatter to the ground behind you, but by the time you look back, it's already gone.

Your companions follow close behind.

>look hospital
You can't see any such thing.

>look west
You see nothing unexpected in that direction.

>hospital
That's not a verb I recognise.

>go west
The groans of the infected grow louder as you approach. The supplies are within reach, but moving forward is dangerous.
Who will go in? (Type "yourself", "David", or "Laura".)
That's not a valid choice. Type "yourself", "David", or "Laura".

>laura
That's not a verb I recognise.

>Laura
That's not a verb I recognise.

* * *

>go west
As you step into the Hospital, bottle of water slips out of your open backpack. You hear it clatter to the ground behind you, but by the time you look back, it's already gone.

Your companions follow close behind.

>restart
Are you sure you want to restart?

>y
You woke up from a quick nap on some cardboard box. The world through the apartment's window is straight out of your worst nightmare. People rustling garbage, scavenging for anything useful. Zombies roam the street, waiting for their next prey to feast on.

No More Room
An Interactive Fiction by Damian Nguyen
Release 1 / Serial number 250221 / Inform 7 v10.1.2 / D

Broken down apartment
Your home, or at least a shell of what it was before the outbreak. Amidst all the chaos, you still chose this place at your base of operation.

You can see Laura and David here.

>close backpack
You zip up the backpack, securing everything inside.

* * *

>go west
The ICU is a dark, ruined ward filled with overturned beds and broken medical equipment. The supplies are within reach, but so is death. The groans of the infected grow louder as you approach.
Who will go in? (Type "send yourself", "send David", or "send Laura".)

>send David
David nods and limps toward the ICU. He moves slower than you'd like, but he manages to grab the supplies. Just as he turns back, a zombie lunges at him-he barely fights it off and escapes. Back at the apartment, he insists he's fine.

Broken down apartment
Your home, or at least a shell of what it was before the outbreak. Amidst all the chaos, you still chose this place at your base of operation.

David starts to experience a violent spasm. His eyes twitch, and his hands claw at the dirt. His mouth foams as he groans in pain. You spot a bite mark about two centimeters deep in his bad leg-he must have gotten that in the ICU and hid it from you.
You only have enough supplies to save one. Who will you choose? (Type "use medical supplies on David" or "use medical supplies on Laura").

Your companions follow close behind.

* * *

You woke up from a quick nap on some cardboard box. The world through the apartment's window is straight out of your worst nightmare. People rustling garbage, scavenging for anything useful. Zombies roam the street, waiting for their next prey to feast on.

No More Room
An Interactive Fiction by Damian Nguyen
Release 1 / Serial number 250221 / Inform 7 v10.1.2 / D

Broken down apartment
Your home, or at least a shell of what it was before the outbreak. Amidst all the chaos, you still chose this place at your base of operation.

You can see Laura and David here.

>inventory
You are carrying:
  a backpack
    a knife
    a bottle of water
    a pistol

>close backpack
You zip up the backpack, securing everything inside.

* * *

>send Laura
Laura moves like a shadow, slipping through gaps in the horde. She returns with the supplies, completely unharmed. Maybe her cheerleading days actually paid off.

Broken down apartment
Your home, or at least a shell of what it was before the outbreak. Amidst all the chaos, you still chose this place at your base of operation.

Your companions follow close behind.

>open backpack
You unzip the backpack and see the few supplies you have left, carefully packed away. What do you want to take or do next?

* * *

>close backpack
You zip up the backpack, securing everything inside.

>north
Your companions follow close behind.

>look
Supermarket
The supermarket is a chaotic mess, with overturned shelves, shattered glass, and rotting food scattered everywhere. The faint smell of decay lingers in the air. Despite the destruction, there might still be useful supplies here-if you're brave enough to search.

You can see Laura, David, a canned food, a flashlight and a zombie here.

>take canned food
The zombie lunges at you as you reach for the canned food! You barely manage to dodge its grasp.
You scramble back, realizing you're unarmed. You'll need a weapon to deal with this threat.

    *** You were overwhelmed by the zombie. ***

Would you like to RESTART, RESTORE a saved game, QUIT or UNDO the last command?

>restart
You woke up from a quick nap on some cardboard box. The world through the apartment's window is straight out of your worst nightmare. People rustling garbage, scavenging for anything useful. Zombies roam the street, waiting for their next prey to feast on.

No More Room
An Interactive Fiction by Damian Nguyen
Release 1 / Serial number 250214 / Inform 7 v10.1.2 / D

Broken down apartment
Your home, or at least a shell of what it was before the outbreak. Amidst all the chaos, you still chose this place at your base of operation.

You can see Laura and David here.

>look backpack
A simple, worn-out backpack that holds your few remaining supplies. It's clear that you can't carry much more, every item inside is critical to your survival.

In the backpack are a knife, a bottle of water and a pistol.

>take knife
Taken.

>north
As you step into the Supermarket, pistol slips out of your open backpack. You hear it clatter to the ground behind you, but by the time you look back, it's already gone.

Your companions follow close behind.

>look
Supermarket
The supermarket is a chaotic mess, with overturned shelves, shattered glass, and rotting food scattered everywhere. The faint smell of decay lingers in the air. Despite the destruction, there might still be useful supplies here-if you're brave enough to search.

You can see Laura, David, a canned food, a flashlight and a zombie here.

>take flashlight
Taken.

>take canned food
The zombie lunges at you as you reach for the canned food! You barely manage to dodge its grasp.
You quickly pull out your knife and stab the zombie in the head. It collapses to the ground, lifeless.

* * *

>close backpack
You zip up the backpack, securing everything inside.

>talk to laura
Laura: Just woke up huh. I think we have stayed here long enough, and we are running low on supplies, the city border is not too far away too. I really miss my parents, I have hope that she survived. Everything just happen really fast you know.

>talk to david
David: Running out of lucky star now, I am on my last leg *chuckle*. You got a strong heart kid. Right now we need to resupply and focus on our journey to reach the city border. Maybe we should try for the hospital, there might be something useful there. The journey shouldn't be too far, it is just west from where we are.

>go west
Your companions follow close behind.

* * *

>send Laura
Laura moves like a shadow, slipping through gaps in the horde. She returns with the supplies, completely unharmed. Maybe her cheerleading days actually paid off.

Broken down apartment
Your home, or at least a shell of what it was before the outbreak. Amidst all the chaos, you still chose this place at your base of operation.

Your companions follow close behind.

>go north
Your companions follow close behind.

* * *

>take canned food
The zombie lunges at you as you reach for the canned food! You barely manage to dodge its grasp.
You have a split second to act. What will you do? (Type "use knife" or "use pistol".)

>use pistol
You pull out your gun and fire. The zombie's head snaps back, and it crumples to the floor.
That's not a weapon you can use.

* * *

You woke up from a quick nap on some cardboard box. The world through the apartment's window is straight out of your worst nightmare. People rustling garbage, scavenging for anything useful. Zombies roam the street, waiting for their next prey to feast on.

No More Room
An Interactive Fiction by Damian Nguyen
Release 1 / Serial number 250221 / Inform 7 v10.1.2 / D

Broken down apartment
Your home, or at least a shell of what it was before the outbreak. Amidst all the chaos, you still chose this place at your base of operation.

You can see Laura and David here.

>look
Broken down apartment
Your home, or at least a shell of what it was before the outbreak. Amidst all the chaos, you still chose this place at your base of operation.

You can see Laura and David here.

>close backpack
You zip up the backpack, securing everything inside.

* * *

>send Laura
Laura moves like a shadow, slipping through gaps in the horde. She returns with the supplies, completely unharmed. Maybe her cheerleading days actually paid off.

Broken down apartment
Your home, or at least a shell of what it was before the outbreak. Amidst all the chaos, you still chose this place at your base of operation.

Your companions follow close behind.

>inventory
You are carrying:
  a medical supplies
  a backpack

>look backpack
A simple, worn-out backpack that holds your few remaining supplies. It's clear that you can't carry much more, every item inside is critical to your survival.

>open backpack
You unzip the backpack and see the few supplies you have left, carefully packed away. What do you want to take or do next?

>inventory
You are carrying:
  a medical supplies
  a backpack
    a knife
    a bottle of water
    a pistol

* * *

>look
Broken down apartment
Your home, or at least a shell of what it was before the outbreak. Amidst all the chaos, you still chose this place at your base of operation.

You can see Laura and David here.

>go west
As you step into the Hospital, knife slips out of your open backpack. You hear it clatter to the ground behind you, but by the time you look back, it's already gone.

Your companions follow close behind.

>look
Hospital
A broken down hospital, its walls cracked and windows shattered. The air is thick with the scent of decay, and the flickering lights barely illuminate the bloodstained floors. Old hospital equipment lies abandoned, rusted and covered in dust. The faint sound of groaning and shuffling echoes from the ICU, where the infected have become trapped. A few scattered medical supplies glint under the dim light, offering a glimmer of hope amidst the chaos. This might come in handy in the future.

You can see Laura and David here.

>go east
You can't go that way.

>back
That's not a verb I recognise.

>east
You can't go that way.

>west
The ICU is a dark, ruined ward filled with overturned beds and broken medical equipment. The supplies are within reach, but so is death. The groans of the infected grow louder as you approach.
Who will go in? (Type "send yourself", "send David", or "send Laura".)

>

>send Laura
Laura moves like a shadow, slipping through gaps in the horde. She returns with the supplies, completely unharmed. Maybe her cheerleading days actually paid off.

Broken down apartment
You woke up from a quick nap on some cardboard box. The world through the apartment's window is straight out of your worst nightmare. People rustling garbage, scavenging for anything useful. Zombies roam the street, waiting for their next prey to feast on

Your companions follow close behind.

>

* * *

>look
Hospital
A broken down hospital, its walls cracked and windows shattered. The air is thick with the scent of decay, and the flickering lights barely illuminate the bloodstained floors. Old hospital equipment lies abandoned, rusted and covered in dust. The faint sound of groaning and shuffling echoes from the ICU, where the infected have become trapped. A few scattered medical supplies glint under the dim light, offering a glimmer of hope amidst the chaos. This might come in handy in the future.

You can see Laura and David here.

>go west
The ICU is a dark, ruined ward filled with overturned beds and broken medical equipment. The supplies are within reach, but so is death. The groans of the infected grow louder as you approach.
Who will go in? (Type "send yourself", "send David", or "send Laura".)

>

>send Laura
Laura moves like a shadow, slipping through gaps in the horde. She returns with the supplies, completely unharmed. Maybe her cheerleading days actually paid off.

Broken down apartment
Your home, or at least a shell of what it was before the outbreak. Amidst all the chaos, you still chose this place at your base of operation.

Your companions follow close behind.

>

* * *

You woke up from a quick nap on some cardboard box. The world through the apartment's window is straight out of your worst nightmare. People rustling garbage, scavenging for anything useful. Zombies roam the street, waiting for their next prey to feast on.

No More Room
An Interactive Fiction by Damian Nguyen
Release 1 / Serial number 250221 / Inform 7 v10.1.2 / D

Broken down apartment
Your home, or at least a shell of what it was before the outbreak. Amidst all the chaos, you still chose this place at your base of operation.

You can see Laura and David here.

>look backpack
A simple, worn-out backpack that holds your few remaining supplies. It's clear that you can't carry much more, every item inside is critical to your survival.

In the backpack are a knife and a bottle of water.

>open backpack
The backpack is already open.

>take knife
Taken.

>inventory
You are carrying:
  a knife
  a backpack
    a bottle of water

>put knife in backpack
You put the knife into the backpack.

>close backpack
You zip up the backpack, securing everything inside.

* * *

You woke up from a quick nap on some cardboard box. The world through the apartment's window is straight out of your worst nightmare. People rustling garbage, scavenging for anything useful. Zombies roam the street, waiting for their next prey to feast on.

No More Room
An Interactive Fiction by Damian Nguyen
Release 1 / Serial number 250221 / Inform 7 v10.1.2 / D

Broken down apartment
Your home, or at least a shell of what it was before the outbreak. Amidst all the chaos, you still chose this place at your base of operation.

You can see Laura and David here.

>look david
Once full of life and confidence, the once brave firefighter now relies on a crutch to support his damaged leg. Despite his condition, his sharp eyes still retain a flicker of the person he used to be. His once gruff demeanor has softened, but it's clear he struggles every day just to survive.

>look laura
The kid is still too young to fully understand the horror of what's happening around her. Used to be a high school student and captain of the cheerleading team, her eyes carry a mixture of innocence and fear, but you can see a surprising resilience in her-she's survived this long when so many others haven't. Her hands tremble when she holds a weapon, but she's learning fast.

>go west
As you step into the Hospital, pistol slips out of your open backpack. You hear it clatter to the ground behind you, but by the time you look back, it's already gone.

Your companions follow close behind.

>go west
The ICU is a dark, ruined ward filled with overturned beds and broken medical equipment. The groans of the infected fill the air, their bodies slumped against the barricaded entrance. The supplies are within reach, but so is death. The groans of the infected grow louder as you approach. The supplies are within reach, but moving forward is dangerous.
Who will go in? (Type "send yourself", "send David", or "send Laura".)

>

* * *

>look laura
The kid is still too young to fully understand the horror of what's happening around her. Used to be a high school student and captain of the cheerleading team, her eyes carry a mixture of innocence and fear, but you can see a surprising resilience in her-she's survived this long when so many others haven't. Her hands tremble when she holds a weapon, but she's learning fast.

>look hospital
You can't see any such thing.

>go west
As you step into the Hospital, bottle of water slips out of your open backpack. You hear it clatter to the ground behind you, but by the time you look back, it's already gone.

Your companions follow close behind.

* * *

>look hospital
You can't see any such thing.

>hospital
That's not a verb I recognise.

* * *

You woke up from a quick nap on some cardboard box. The world through the apartment's window is straight out of your worst nightmare. People rustling garbage, scavenging for anything useful. Zombies roam the street, waiting for their next prey to feast on.

No More Room
An Interactive Fiction by Damian Nguyen
Release 1 / Serial number 250221 / Inform 7 v10.1.2 / D

Broken down apartment
Your home, or at least a shell of what it was before the outbreak. Amidst all the chaos, you still chose this place at your base of operation.

You can see Laura and David here.

>look self
You, a weary survivor, wake up with the weight of the world on your shoulders. The familiar ache in your bones reminds you of how long it's been since you slept in a real bed. You look around to see your companions in the same state: exhausted, broken, yet somehow still here. You carry a backpack given to you by your parents, right before they start developing a taste for human flesh.

>look player
You can't see any such thing.

>self
That's not a verb I recognise.

* * *

>look self
You, a weary survivor, wake up with the weight of the world on your shoulders. The familiar ache in your bones reminds you of how long it's been since you slept in a real bed. You look around to see your companions in the same state: exhausted, broken, yet somehow still here. You carry a backpack given to you by your parents, right before they start developing a taste for human flesh.

>open backpack
The backpack is already open.

>close backpack
You zip up the backpack, securing everything inside.

>open backpack
You unzip the backpack and see the few supplies you have left, carefully packed away. What do you want to take or do next?

>take knife
Taken.

* * *

>put knife in backpack
You put the knife into the backpack.

>inventory
You are carrying:
  a backpack
    a knife
    a bottle of water

* * *

>open backpack
The backpack is already open.

>open the backpack
It isn't something you can open.

* * *

You woke up from a quick nap on some cardboard box. The world through the apartment's window is straight out of your worst nightmare. People rustling garbage, scavenging for anything useful. Zombies roam the street, waiting for their next prey to feast on.

No More Room
An Interactive Fiction by Damian Nguyen
Release 1 / Serial number 250221 / Inform 7 v10.1.2 / D

Broken down apartment
Your home, or at least a shell of what it was before the outbreak. Amidst all the chaos, you still chose this place at your base of operation.

You can see Laura and David here.

>look you
You can't see any such thing.

>look self
You, a weary survivor, wake up with the weight of the world on your shoulders. The familiar ache in your bones reminds you of how long it's been since you slept in a real bed. You look around to see your companions in the same state: exhausted, broken, yet somehow still here. You carry a backpack given to you by your parents, right before they start developing a taste for human flesh.

>look backpack
A simple, worn-out backpack that holds your few remaining supplies. It's clear that you can't carry much more, every item inside is critical to your survival.

In the backpack are a knife, a bottle of water and a pistol.

>look pistol
A standard 1911 pistol that shoots .45 ACP rounds. Besides your parents, this is the thing that you trust the most.

* * *

You woke up from a quick nap on some cardboard box. The world through the apartment's window is straight out of your worst nightmare. People rustling garbage, scavenging for anything useful. Zombies roam the street, waiting for their next prey to feast on.

No More Room
An Interactive Fiction by Damian Nguyen
Release 1 / Serial number 250221 / Inform 7 v10.1.2 / D

Broken down apartment
Your home, or at least a shell of what it was before the outbreak. Amidst all the chaos, you still chose this place at your base of operation.

You can see Laura and David here.

>map
MAP ─────────────────────────────────────── [Park] │ [Office Complex] - [Supermarket] │ [City Border]

[ICU] - [Hospital] - [Broken Down Apartment] ─────────────────────────────────────── (Current Location: Broken down apartment)

>close backpack
You zip up the backpack, securing everything inside.

* * *

>look hospital
You can't see any such thing.

>inspect
That's not a verb I recognise.

>take hospital
You can't see any such thing.

>look The hospital
You can't see any such thing.

* * *

>map
MAP ─────────────────────────────────────── [Park] │ [Office Complex] - [Supermarket] │ [City Border]

[ICU] - [Hospital] - [Broken Down Apartment] ─────────────────────────────────────── (Current Location: Broken down apartment)

>look
Broken down apartment
You woke up from a quick nap on some cardboard box. The world through the apartment's window is straight out of your worst nightmare. People rustling garbage, scavenging for anything useful. Zombies roam the street, waiting for their next prey to feast on

You can see David and Laura here.

>look west
You see nothing unexpected in that direction.

>west
As you step into the Hospital, bottle of water slips out of your open backpack. You hear it clatter to the ground behind you, but by the time you look back, it's already gone.

Your companions follow close behind.

>west
Your companions follow close behind.

>look
ICU
You can see Laura and David here.

* * *

>map
MAP ─────────────────────────────────────── [Park] │ [Office Complex] - [Supermarket] │ [City Border]

[ICU] - [Hospital] - [Broken Down Apartment] ─────────────────────────────────────── (Current Location: Broken down apartment)

>look map
You can't see any such thing.

>go west
As you step into the Hospital, something slips out of your open backpack. You hear it clatter to the ground behind you, but by the time you look back, it's already gone.

Your companions follow close behind.

>look backpack
A simple, worn-out backpack that holds your few remaining supplies. It's clear that you can't carry much more, every item inside is critical to your survival.

* * *

>look inventory
You can't see any such thing.

>inventory
You are carrying:
  a backpack
    a knife
    a pistol

* * *

>map
MAP ─────────────────────────────────────── [Park] │ [Office Complex] - [Supermarket] │ [City Border]

[ICU] - [Hospital] - [Broken Down Apartment] ─────────────────────────────────────── (Current Location: Broken down apartment)

>north
As you step into the Supermarket, bottle of water slips out of your open backpack. You hear it clatter to the ground behind you, but by the time you look back, it's already gone.

Your companions follow close behind.

>look
Supermarket
The supermarket is a chaotic mess, with overturned shelves, shattered glass, and rotting food scattered everywhere. The faint smell of decay lingers in the air. Despite the destruction, there might still be useful supplies here-if you're brave enough to search.

You can see Laura, David, a canned food, a flashlight and a zombie here.

>look zombie
A shambling, groaning figure lurking near the entrance. Its milky eyes lock onto you as you approach.

>take canned food
The zombie lunges at you as you reach for the canned food! You barely manage to dodge its grasp.
You scramble back, realizing you're unarmed. You'll need a weapon to deal with this threat.

    *** You were overwhelmed by the zombie. ***

Would you like to RESTART, RESTORE a saved game, QUIT or UNDO the last command?

>undo
Supermarket
[Previous turn undone.]

* * *

>inventory
You are carrying:
  a backpack

>look backpack
A simple, worn-out backpack that holds your few remaining supplies. It's clear that you can't carry much more, every item inside is critical to your survival.

* * *

You woke up from a quick nap on some cardboard box. The world through the apartment's window is straight out of your worst nightmare. People rustling garbage, scavenging for anything useful. Zombies roam the street, waiting for their next prey to feast on.

No More Room
An Interactive Fiction by Damian Nguyen
Release 1 / Serial number 250221 / Inform 7 v10.1.2 / D

Broken down apartment
Your home, or at least a shell of what it was before the outbreak. Amidst all the chaos, you still chose this place at your base of operation.

You can see Laura and David here.

>open backpack
The backpack is already open.

>go west
As you step into the Hospital, pistol slips out of your open backpack. You hear it clatter to the ground behind you, but by the time you look back, it's already gone.

Your companions follow close behind.

* * *

>open backpack
The backpack is already open.

>look backpack
A simple, worn-out backpack that holds your few remaining supplies. It's clear that you can't carry much more, every item inside is critical to your survival.

In the backpack are a knife, a bottle of water and a pistol.

>look pistol
A standard 1911 pistol that shoot .45 ACP rounds. Besides your parents, this is the thing that you trust the most.

* * *

You woke up from a quick nap on some cardboard box. The world through the apartment's window is straight out of your worst nightmare. People rustling garbage, scavenging for anything useful. Zombies roam the street, waiting for their next prey to feast on.

No More Room
An Interactive Fiction by Damian Nguyen
Release 1 / Serial number 250221 / Inform 7 v10.1.2 / D

Broken down apartment
Your home, or at least a shell of what it was before the outbreak. Amidst all the chaos, you still chose this place at your base of operation.

You can see Laura and David here.

>pick a pile of scraps
I didn't understand that sentence.

* * *

You woke up from a quick nap on some cardboard box. The world through the apartment's window is straight out of your worst nightmare. People rustling garbage, scavenging for anything useful. Zombies roam the street, waiting for their next prey to feast on.

No More Room
An Interactive Fiction by Damian Nguyen
Release 1 / Serial number 250221 / Inform 7 v10.1.2 / D

Broken down apartment
Your home, or at least a shell of what it was before the outbreak. Amidst all the chaos, you still chose this place at your base of operation.

You can see Laura and David here.

>s
You can't go that way.

>s
You can't go that way.

I beg your pardon?

I beg your pardon?

* * *

You woke up from a quick nap on some cardboard box. The world through the apartment's window is straight out of your worst nightmare. People rustling garbage, scavenging for anything useful. Zombies roam the street, waiting for their next prey to feast on.

No More Room
An Interactive Fiction by Damian Nguyen
Release 1 / Serial number 250221 / Inform 7 v10.1.2 / D

Broken down apartment
Your home, or at least a shell of what it was before the outbreak. Amidst all the chaos, you still chose this place at your base of operation.

You can see Laura and David here.

>see David
That's not a verb I recognise.

>Look David
You see nothing special about David.

>David
That's not a verb I recognise.

* * *

You woke up from a quick nap on some cardboard box. The world through the apartment's window is straight out of your worst nightmare. People rustling garbage, scavenging for anything useful. Zombies roam the street, waiting for their next prey to feast on.

No More Room
An Interactive Fiction by Damian Nguyen
Release 1 / Serial number 250221 / Inform 7 v10.1.2 / D

Broken down apartment
Your home, or at least a shell of what it was before the outbreak. Amidst all the chaos, you still chose this place at your base of operation.

You can see Laura and David here.

>see protagonist
That's not a verb I recognise.

>protagonist
That's not a verb I recognise.

>look protagonist
You, a weary survivor, wake up with the weight of the world on your shoulders. The familiar ache in your bones reminds you of how long it's been since you slept in a real bed. You look around to see your companions in the same state: exhausted, broken, yet somehow still here.

>look crippled man
Once full of life and confidence, the once brave firefighter now relies on a crutch to support his damaged leg. Despite his condition, his sharp eyes still retain a flicker of the person he used to be. His once gruff demeanor has softened, but it's clear he struggles every day just to survive.

* * *

You woke up from a quick nap on some cardboard box. The world through the apartment's window is straight out of your worst nightmare. People rustling garbage, scavenging for anything useful. Zombies roam the street, waiting for their next prey to feast on.

No More Room
An Interactive Fiction by Damian Nguyen
Release 1 / Serial number 250221 / Inform 7 v10.1.2 / D

Broken down apartment
Your home, or at least a shell of what it was before the outbreak. Amidst all the chaos, you still chose this place at your base of operation.

You can see Laura and David here.

>take bottle of water
Taken.

>take knife
Taken.

>take pistol
Taken.

>go west
Your companions follow close behind.

* * *

>go north
Your companions follow close behind.

>take canned food
The zombie lunges at you as you reach for the canned food! You barely manage to dodge its grasp.
You quickly pull out your knife and stab the zombie in the head. It collapses to the ground, lifeless.

>inventory
You are carrying:
  a medical supplies
  a pistol
  a knife
  a bottle of water
  a backpack

>take canned food
Taken.

>inventory
You are carrying:
  a canned food
  a medical supplies
  a pistol
  a knife
  a bottle of water
  a backpack

>go north
You can't go that way.

* * *

>go west
Your companions follow close behind.

>look
Office Complex
A dilapidated office building with shattered windows and debris scattered everywhere. The air smells of dust and decay. A lone survivor stands near the entrance, looking desperate. Your group seems lost, you should ask someone for direction

You can see Laura, David and Jisoo here.

>ask jisoo about something
"Do you have any food or water?" Jisoo asks, her voice trembling. "I haven't eaten in days..."

You hand her the canned food and water. Her eyes light up with gratitude. "Thank you so much!" she says, clutching the items tightly.

After a moment, she looks at you with a serious expression. "Listen, there's a military supply drop happening at the park north of here. But there's a horde of zombies blocking the way. I can help you get past them."

Jisoo steps forward and begins singing a haunting melody. The zombies, drawn to the sound, start shuffling toward her. "Go now!" she whispers. "I'll keep them distracted."

>go north
With Jisoo's song drawing the zombies away, you quickly make your way to the park.

Park
A large, open park that was once a place of joy and relaxation. Now, it's a grim reminder of the world's collapse. A military supply crate sits in the center, surrounded by the remains of a zombie horde.

You can see a military supply crate here.

Your companions follow close behind.

* * *

You woke up from a quick nap on some cardboard box. The world through the apartment's window is straight out of your worst nightmare. People rustling garbage, scavenging for anything useful. Zombies roam the street, waiting for their next prey to feast on.

No More Room
An Interactive Fiction by Damian Nguyen
Release 1 / Serial number 250221 / Inform 7 v10.1.2 / D

Broken down apartment
Your home, or at least a shell of what it was before the outbreak. Amidst all the chaos, you still chose this place at your base of operation.

You can see Laura and David here.

>take knife
Taken.

>take bottle of water
Taken.

>go west
As you step into the Hospital, pistol slips out of your open backpack. You hear it clatter to the ground behind you, but by the time you look back, it's already gone.

Your companions follow close behind.

>go west
The ICU is a dark, ruined ward filled with overturned beds and broken medical equipment. The supplies are within reach, but so is death. The groans of the infected grow louder as you approach.
Who will go in? (Type "send yourself", "send David", or "send Laura".)

* * *

>send Laura
Laura moves like a shadow, slipping through gaps in the horde. She returns with the supplies, completely unharmed. Maybe her cheerleading days actually paid off.

Broken down apartment
Your home, or at least a shell of what it was before the outbreak. Amidst all the chaos, you still chose this place at your base of operation.

Your companions follow close behind.

>go west
Your companions follow close behind.

* * *

>take canned food
The zombie lunges at you as you reach for the canned food! You barely manage to dodge its grasp.
You quickly pull out your knife and stab the zombie in the head. It collapses to the ground, lifeless.

>take canned food
Taken.

>go west
Your companions follow close behind.

>ask jisoo about something
"Do you have any food or water?" Jisoo asks, her voice trembling. "I haven't eaten in days..."

You hand her the canned food and water. Her eyes light up with gratitude. "Thank you so much!" she says, clutching the items tightly.

After a moment, she looks at you with a serious expression. "Listen, there's a military supply drop happening at the park north of here. But there's a horde of zombies blocking the way. I can help you get past them."

Jisoo steps forward and begins singing a haunting melody. The zombies, drawn to the sound, start shuffling toward her. "Go now!" she whispers. "I'll keep them distracted."

>go north
With Jisoo's song drawing the zombies away, you quickly make your way to the park.

Park
A large, open park that was once a place of joy and relaxation. Now, it's a grim reminder of the world's collapse. A military supply crate sits in the center, surrounded by the remains of a zombie horde.

You can see a military supply crate and M249 here.

Your companions follow close behind.

>take m249
Taken.

>go north
You can't go that way.

>go south
Your companions follow close behind.

>go south
You grip the M249 tightly and unleash a storm of bullets into the horde. The sheer firepower tears through the undead, clearing a path. "Go! Now!" you shout, leading the group forward.
David, Laura, and you sprint through the carnage, making it past the city border. You've survived.

    *** You and your group have escaped the city! ***

Would you like to RESTART, RESTORE a saved game, QUIT or UNDO the last command?

* * *

>take bottle of water
Taken.

>look laura
The kid is still too young to fully understand the horror of what's happening around her. Used to be a high school student and captain of the cheerleading team, her eyes carry a mixture of innocence and fear, but you can see a surprising resilience in her-she's survived this long when so many others haven't. Her hands tremble when she holds a weapon, but she's learning fast.

>west
As you step into the Hospital, pistol slips out of your open backpack. You hear it clatter to the ground behind you, but by the time you look back, it's already gone.

Your companions follow close behind.

>west
The ICU is a dark, ruined ward filled with overturned beds and broken medical equipment. The supplies are within reach, but so is death. The groans of the infected grow louder as you approach.
Who will go in? (Type "send yourself", "send David", or "send Laura".)

>send Laura
Laura moves like a shadow, slipping through gaps in the horde. She returns with the supplies, completely unharmed. Maybe her cheerleading days actually paid off.

Broken down apartment
Your home, or at least a shell of what it was before the outbreak. Amidst all the chaos, you still chose this place at your base of operation.

Your companions follow close behind.

>north
Your companions follow close behind.

* * *

>take canned food
Taken.

>take flashlight
Taken.

>west
Your companions follow close behind.

>ask jisoo about something
"Do you have any food or water?" Jisoo asks, her voice trembling. "I haven't eaten in days..."

You hand her the canned food and water. Her eyes light up with gratitude. "Thank you so much!" she says, clutching the items tightly.

After a moment, she looks at you with a serious expression. "Listen, there's a military supply drop happening at the park north of here. But there's a horde of zombies blocking the way. I can help you get past them."

Jisoo steps forward and begins singing a haunting melody. The zombies, drawn to the sound, start shuffling toward her. "Go now!" she whispers. "I'll keep them distracted."

* * *

>take m249
Taken.

>go supermarket
You can't see any such thing.

* * *

>take bottle of water
Taken.

>west
As you step into the Hospital, pistol slips out of your open backpack. You hear it clatter to the ground behind you, but by the time you look back, it's already gone.

Your companions follow close behind.

>look
Hospital
A broken down hospital, its walls cracked and windows shattered. The air is thick with the scent of decay, and the flickering lights barely illuminate the bloodstained floors. Old hospital equipment lies abandoned, rusted and covered in dust. The faint sound of groaning and shuffling echoes from the ICU, where the infected have become trapped. A few scattered medical supplies glint under the dim light, offering a glimmer of hope amidst the chaos. This might come in handy in the future.

You can see Laura and David here.

>west
The ICU is a dark, ruined ward filled with overturned beds and broken medical equipment. The supplies are within reach, but so is death. The groans of the infected grow louder as you approach.
Who will go in? (Type "send yourself", "send David", or "send Laura".)

>send David
David nods and limps toward the ICU. He moves slower than you'd like, but he manages to grab the supplies. Just as he turns back, a zombie lunges at him-he barely fights it off and escapes. Back at the apartment, he insists he's fine.

Broken down apartment
Your home, or at least a shell of what it was before the outbreak. Amidst all the chaos, you still chose this place at your base of operation.

Your companions follow close behind.

* * *

>take knife
Taken.

>take bottle of watter
I only understood you as far as wanting to take the bottle of water.

>inventory
You are carrying:
  a knife
  a backpack
    a bottle of water
    a pistol

>take bottle of water
Taken.

>take pistol
Taken.

* * *

>go west
The ICU is a dark, ruined ward filled with overturned beds and broken medical equipment. The supplies are within reach, but so is death. The groans of the infected grow louder as you approach.
Who will go in? (Type "send yourself", "send David", or "send Laura".)

>sned Laura
That's not a verb I recognise.

>send Laura
Laura moves like a shadow, slipping through gaps in the horde. She returns with the supplies, completely unharmed. Maybe her cheerleading days actually paid off.

Broken down apartment
Your home, or at least a shell of what it was before the outbreak. Amidst all the chaos, you still chose this place at your base of operation.

Your companions follow close behind.

* * *

>take canned food
The zombie lunges at you as you reach for the canned food! You barely manage to dodge its grasp.
You quickly pull out your knife and stab the zombie in the head. It collapses to the ground, lifeless.

>take flashlight
Taken.

>take canned food
Taken.

>drop canned food
Dropped.

>go north
You can't go that way.

* * *

>look
Office Complex
A dilapidated office building with shattered windows and debris scattered everywhere. The air smells of dust and decay. A lone survivor stands near the entrance, looking desperate. Your group seems lost, you should ask someone for direction

You can see Laura, David and Jisoo here.

>ask jisoo about something
"Do you have any food or water?" Jisoo asks, her voice trembling. "I haven't eaten in days... I need both to survive."
You offer her the water, but she shakes her head. "I need food too... Please, I can't survive without both."

>go north
A massive horde of zombies blocks the way to the park. You'll need to find a way to distract them.

>go north
A massive horde of zombies blocks the way to the park. You'll need to find a way to distract them.

* * *

>take knife
Taken.

>take watter bottle
You can't see any such thing.

>look backpack
A simple, worn-out backpack that holds your few remaining supplies. It's clear that you can't carry much more, every item inside is critical to your survival.

In the backpack are a bottle of water and a pistol.

>take bottle of water
Taken.

>inventory
You are carrying:
  a bottle of water
  a knife
  a backpack
    a pistol

>take pistol
Taken.

* * *

You woke up from a quick nap on some cardboard box. The world through the apartment's window is straight out of your worst nightmare. People rustling garbage, scavenging for anything useful. Zombies roam the street, waiting for their next prey to feast on.

No More Room
An Interactive Fiction by Damian Nguyen
Release 1 / Serial number 250221 / Inform 7 v10.1.2 / D

Broken down apartment
Your home, or at least a shell of what it was before the outbreak. Amidst all the chaos, you still chose this place at your base of operation.

You can see Laura and David here.

>take water bottle
Taken.

>take knife
Taken.

>close backpack
You zip up the backpack, securing everything inside.

* * *

>go west
The ICU is a dark, ruined ward filled with overturned beds and broken medical equipment. The supplies are within reach, but so is death. The groans of the infected grow louder as you approach.
Who will go in? (Type "send yourself", "send David", or "send Laura".)

>send laura
Laura moves like a shadow, slipping through gaps in the horde. She returns with the supplies, completely unharmed. Maybe her cheerleading days actually paid off.

Broken down apartment
Your home, or at least a shell of what it was before the outbreak. Amidst all the chaos, you still chose this place at your base of operation.

Your companions follow close behind.

* * *

>take flashlight
Taken.

>go north
You can't go that way.

* * *

>go west
Your companions follow close behind.

>look
Office Complex
A dilapidated office building with shattered windows and debris scattered everywhere. The air smells of dust and decay. A lone survivor stands near the entrance, looking desperate.

You can see Laura, David and Jisoo here.

>look jisoo
A weary survivor with a determined look in her eyes. She seems to be guarding the entrance, but her posture suggests she's in need of help.

>ask jisoo
What do you want to ask Jisoo for?

>ask jisoo about something
"Do you have any food or water?" Jisoo asks, her voice trembling. "I haven't eaten in days... I need both to survive."
You offer her the water, but she shakes her head. "I need food too... Please, I can't survive without both."

* * *

You woke up from a quick nap on some cardboard box. The world through the apartment's window is straight out of your worst nightmare. People rustling garbage, scavenging for anything useful. Zombies roam the street, waiting for their next prey to feast on.

No More Room
An Interactive Fiction by Damian Nguyen
Release 1 / Serial number 250221 / Inform 7 v10.1.2 / D

Broken down apartment
Your home, or at least a shell of what it was before the outbreak. Amidst all the chaos, you still chose this place at your base of operation.

You can see Laura and David here.

>talk to David
David: Running out of lucky star now, I am on my last leg *chuckle*. You got a strong heart kid. Right now we need to resupply and focus on our journey to reach the city border.

* * *

You woke up from a quick nap on some cardboard box. The world through the apartment's window is straight out of your worst nightmare. People rustling garbage, scavenging for anything useful. Zombies roam the street, waiting for their next prey to feast on.

No More Room
An Interactive Fiction by Damian Nguyen
Release 1 / Serial number 250221 / Inform 7 v10.1.2 / D

Broken down apartment
Your home, or at least a shell of what it was before the outbreak. Amidst all the chaos, you still chose this place at your base of operation.

You can see Laura and David here.

>talk to Laura
Laura: Just woke up huh. I think we have stayed here long enough, and we are running low on supplies, the city border is not too far away too. I really miss my parents, I have hope that she survived. Everything just happen really fast you know.

>talk to David
David: Running out of lucky star now, I am on my last leg *chuckle*. You got a strong heart kid. Right now we need to resupply and focus on our journey to reach the city border. Maybe we should try for the hospital, there might be something useful there. The journey shouldn't be too far, it is just west from where we are.

>close backpack
You zip up the backpack, securing everything inside.

* * *

>go west
Your companions follow close behind.

>talk to David
David: There is nothing out here. Damn savages have looted everything. It's a shame. We could also try our luck in the ICU. But the place is crawling with walkers. Who would have thought seperating a bunch of vulnerable people would create a hell hole on Earth.

>talk to Laura
If we have to go into the ICU, that would be very risky. We might disturb the horde and we don't know if we can find anything useful in there. It is your call, I trust your decision.

>go west
The ICU is a dark, ruined ward filled with overturned beds and broken medical equipment. The supplies are within reach, but so is death. The groans of the infected grow louder as you approach.
Who will go in? (Type "send yourself", "send David", or "send Laura".)

* * *

>go north
Your companions follow close behind.

>talk to David
We should look around for anything that might be useful: food, water and any weapon is useful. It is a long road ahead

>talk to Laura
I think after this stop we can continue west to the Deli store west of here. That will help us avoid the open street crawling with zombies. Yikes!

>look
Supermarket
The supermarket is a chaotic mess, with overturned shelves, shattered glass, and rotting food scattered everywhere. The faint smell of decay lingers in the air. Despite the destruction, there might still be useful supplies here-if you're brave enough to search.

You can see Laura, David, a canned food, a flashlight and a zombie here.

* * *

>go west
Shadows shift in the corners. Hooded figures emerge from behind the counter. They are all wearing some sort of white outfits with orange hoods. One of them shouts, "The unclean must be purged!" before gunfire erupts. You manage to drive them away with your pistol, but it seems that Laura caught a stray bullet.

>talk to Laura
I think after this stop we can continue west to the Deli store west of here. That will help us avoid the open street crawling with zombies. Yikes!

>open backpack
You unzip the backpack and see the few supplies you have left, carefully packed away. What do you want to take or do next?

* * *

>inventory
You are carrying:
  a backpack
    a medical supplies
    a knife
    a bottle of water
    a pistol

>talk to Laura
I think after this stop we can continue west to the Deli store west of here. That will help us avoid the open street crawling with zombies. Yikes!

* * *

You woke up from a quick nap on some cardboard box. The world through the apartment's window is straight out of your worst nightmare. People rustling garbage, scavenging for anything useful. Zombies roam the street, waiting for their next prey to feast on.

No More Room
An Interactive Fiction by Damian Nguyen
Release 1 / Serial number 250221 / Inform 7 v10.1.2 / D

Broken down apartment
Your home, or at least a shell of what it was before the outbreak. Amidst all the chaos, you still chose this place at your base of operation.

You can see Laura and David here.

>talk to david
David: Running out of lucky star now, I am on my last leg *chuckle*. You got a strong heart kid. Right now we need to resupply and focus on our journey to reach the city border. Maybe we should try for the hospital, there might be something useful there. The journey shouldn't be too far, it is just west from where we are

>talk to laura
Laura: Just woke up huh. I think we have stayed here long enough, and we are running low on supplies, the city border is not too far away too. I really miss my parents, I have hope that she survived. Everything just happen really fast you know

>look you
You can't see any such thing.

>look yourself
You can't see any such thing.

>look player
You can't see any such thing.

>look david
Once full of life and confidence, the once brave firefighter now relies on a crutch to support his damaged leg. Despite his condition, his sharp eyes still retain a flicker of the person he used to be. His once gruff demeanor has softened, but it's clear he struggles every day just to survive.

* * *

>look laura
The kid is still too young to fully understand the horror of what's happening around her. Used to be a high school student and captain of the cheerleading team, her eyes carry a mixture of innocence and fear, but you can see a surprising resilience in her-she's survived this long when so many others haven't. Her hands tremble when she holds a weapon, but she's learning fast.

>look self
You, a weary survivor, wake up with the weight of the world on your shoulders. The familiar ache in your bones reminds you of how long it's been since you slept in a real bed. You look around to see your companions in the same state: exhausted, broken, yet somehow still here. You carry a backpack given to you by your parents, right before they start developing a taste for human flesh.

>go west
As you step into the Hospital, knife slips out of your open backpack. You hear it clatter to the ground behind you, but by the time you look back, it's already gone.

Your companions follow close behind.

>talk to david
David: There is nothing out here. Damn savages have looted everything. It's a shame. We could also try our luck in the ICU. But the place is crawling with walkers. Who would have thought seperating a bunch of vulnerable people would create a hell hole on Earth.

>talk to laura
If we have to go into the ICU, that would be very risky. We might disturb the horde and we don't know if we can find anything useful in there. It is your call, I trust your decision

>go west
The ICU is a dark, ruined ward filled with overturned beds and broken medical equipment. The supplies are within reach, but so is death. The groans of the infected grow louder as you approach.
Who will go in? (Type "send yourself", "send David", or "send Laura".)

* * *

>send laura
Laura moves like a shadow, slipping through gaps in the horde. She returns with the supplies, completely unharmed. Maybe her cheerleading days actually paid off.

Broken down apartment
Your home, or at least a shell of what it was before the outbreak. Amidst all the chaos, you still chose this place at your base of operation.

Your companions follow close behind.

>inventory
You are carrying:
  a backpack

* * *

You woke up from a quick nap on some cardboard box. The world through the apartment's window is straight out of your worst nightmare. People rustling garbage, scavenging for anything useful. Zombies roam the street, waiting for their next prey to feast on.

No More Room
An Interactive Fiction by Damian Nguyen
Release 1 / Serial number 250221 / Inform 7 v10.1.2 / D

Broken down apartment
Your home, or at least a shell of what it was before the outbreak. Amidst all the chaos, you still chose this place at your base of operation.

You can see Laura and David here.

>talk to laura
Laura: Just woke up huh. I think we have stayed here long enough, and we are running low on supplies, the city border is not too far away too. I really miss my parents, I have hope that she survived. Everything just happen really fast you know.

>close backpack
You zip up the backpack, securing everything inside.

* * *

>go north
Your companions follow close behind.

>go west
On the way to the deli store, you spot a middle-aged man wearing some sort of white outfit with an orange hood. He holds an assault rifle, and some followers stand behind him, wearing the same outfit. They are mumbling something, almost chant-like. You, sensing a potential threat, decided to use the last of your bullets to distract him.

* * *

>go west
David starts to experience a violent spasm. His eyes twitch, and his hands claw at the dirt. His mouth foams as he groans in pain. You spot a bite mark about two centimeters deep in his good leg-he must have gotten that in the ICU and hid it from you. 

 What will you do? (Amputate David or End David

>Amputate David
That's not a verb I recognise.

>Amputate David
That's not a verb I recognise.

* * *

>talk to laura
Laura: Just woke up huh. I think we have stayed here long enough, and we are running low on supplies, the city border is not too far away too. I really miss my parents, I have hope that she survived. Everything just happen really fast you know.

>talk laura
I didn't understand that sentence.

>talk to laura
You can only do that to something animate.

* * *

>talk to david
David: Running out of lucky star now, I am on my last leg *chuckle*. You got a strong heart kid. Right now we need to resupply and focus on our journey to reach the city border. Maybe we should try for the hospital, there might be something useful there. The journey shouldn't be too far, it is just west from where we are.

>close backpack
You zip up the backpack, securing everything inside.

* * *

>send David
David nods and limps toward the ICU. He moves slower than you'd like, but he manages to grab the supplies. Just as he turns back, a zombie lunges at him-he barely fights it off and escapes. Back at the apartment, he insists he's fine.

Broken down apartment
Your home, or at least a shell of what it was before the outbreak. Amidst all the chaos, you still chose this place at your base of operation.

Your companions follow close behind.

>talk to david
David: Running out of lucky star now, I am on my last leg *chuckle*. You got a strong heart kid. Right now we need to resupply and focus on our journey to reach the city border. Maybe we should try for the hospital, there might be something useful there. The journey shouldn't be too far, it is just west from where we are.

* * *

You woke up from a quick nap on some cardboard box. The world through the apartment's window is straight out of your worst nightmare. People rustling garbage, scavenging for anything useful. Zombies roam the street, waiting for their next prey to feast on.

No More Room
An Interactive Fiction by Damian Nguyen
Release 1 / Serial number 250221 / Inform 7 v10.1.2 / D

Broken down apartment
Your home, or at least a shell of what it was before the outbreak. Amidst all the chaos, you still chose this place at your base of operation.

You can see Laura and David here.

>west
As you step into the Hospital, knife slips out of your open backpack. You hear it clatter to the ground behind you, but by the time you look back, it's already gone.

Your companions follow close behind.

>west
Your companions follow close behind.

>look
ICU
You can see Laura, David and a medical supplies here.

>west
You can't go that way.

>look west
You see nothing unexpected in that direction.

>look
ICU
You can see Laura, David and a medical supplies here.

>east
You can't go that way.

>north
You can't go that way.

>back
That's not a verb I recognise.